
1111111111111111111111111111111

1000000000000000000010000000011

11111110000000000001P1000000001

10000010000000000000C000C000001

10000010000000000000000000E0001

1111111111111111111111111111111















