1111111111111111111111111111111111
1C1000000100C00C00000C0000000000C1
10100101001000001010010000C0011101
101001000001010010000C0010101C0001
101001E010101010001001000100011101
1010010010101010010010010001010111
1P0000000C00C00000101001000010C001
1010010010101010001001000100010101
1000C0000000000C10000C0010100000C1
1111111111111111111111111111111111